XXXXXXXXXXXXXXXXXXXXXXXXXXXXXXXXXXXXXXXXXXXXXXXXXXXXXXXXXXXXXXXXXXXXXXXXXX
X                                                                        X
X                                                                        X
X                                                                        X
X                                                                        X
X                                                                        X
X                                                                        X
X                                                                        X
X                                                                        X
X                                    X                                   X
X                                    X                                   X
X                                    X                                   X
X                                    X                                   X
X                                    X                                   X
X                                    X                                   X
X                                    X                                   X
X                                    X                                   X
X                                    XXXXXXXXXXXXXXXXXXXXXXXXXXXXXXXXXXXXX
X                                                                        X
X                                                                        X
X                                                                        X
X                                                                        X
X                                                                        X
XXXXXXXXXXXXXXXXXXXXXXXXXXXXXXXXXXXXXXXXXXXXXXXXXXXXXXXXXXXXXXXXXXXXXXXXXX