XXXXXXXXXXXXXXXXXXXXXXXXXXXXXXXXXXXXXXXXXXXXXXXXXXXXXXXXXXXXXXXXXXXXXXXXXX
X                                                                N       X
X         *                                                              X
X                                                                        X
X                                                                        X
X                                                                        X
X                                                                        X
X                                                                        X
X                                                                        X
X                              M     X                                   X
X                                    X                                   X
X                                    X                                   X
X                                    X                P                  X
X                                    X                                   X
X                                    X                                   X
X                                    X                                   X
X                                    X               N                   X
X                                    XXXXXXXXXXXXXXXXXXXXXXXXXXXXXXXXXXXXX
X                         M                                            ^ X
X                                                                        X
X                                             M                          X
X                                                                        "
X          O                                                             X
XXXXXXXXXXXXXXXXXXXXXXXXXXXXXXXXXXXXXXXXXXXXXXXXXXXXXXXXXXXXXXXXXXXXXXXXXX