XXXXXXXXXXXXXXXXXXXXXXXXXXXXXXXXXXXXXXXXXXXXXXXXXXXXXXXXXXXXXXXXXXXXXXXXXX
X                                                                        X
X         *                                                              X
X                                                                        X
X                                                                        X
X                                                                        X
X                                                                        X
X                                                                        X
X                                                                        X
X                              M     X                                   X
X                                    X                                   X
X                                    X                                   X
X                                    X                P                  X
X                                    X                                   X
X                                    X                                   X
X                                    X                                   X
X                                    X               V                   X
X                                    XXXXXXXXXXXXXXXXXXXXXXXXXXXXXXXXXXXXX
X                         M                                            ^ X
X                                                                        X
X                                             M                          X
X                                                                       "X
X *        O                                                             X
XXXXXXXXXXXXXXXXXXXXXXXXXXXXXXXXXXXXXXXXXXXXXXXXXXXXXXXXXXXXXXXXXXXXXXXXXX